+---+---+---+---+---+---+---+---+---+---+---+---+---+---+---+
|   |           |           |           |                   |
+   +   +---+   +   +---+   +   +   +---+   +   +---+---+---+
|   |       |   |       |       |           |               |
+   +---+   +   +---+   +---+---+---+---+---+---+---+---+   +
|       |   |       |           |               |           |
+---+   +   +---+---+---+   +---+   +---+---+   +   +---+   +
|       |               |   |       |       |   |   |       |
+   +---+   +---+---+   +   +   +---+---+   +   +   +   +---+
|   |   |   |       |       |   |           |       |   |   |
+   +   +   +   +   +---+---+   +---+   +---+---+---+   +   +
|   |           |           |   |       |           |       |
+   +---+---+---+---+---+   +   +   +---+   +   +---+---+   +
|       |       |           |   |   |       |           |   |
+---+   +   +   +---+---+---+   +   +   +---+---+---+   +   +
|       |   |               |   |       |   |       |   |   |
+   +---+   +---+---+---+   +   +---+   +   +   +   +   +   +
|           |               |       |       |   |       |   |
+---+---+---+   +---+---+---+---+   +---+   +   +---+---+   +
|                                   |       |               |
+---+---+---+---+---+---+---+---+---+---+---+---+---+---+---+
